width 15
height 16
data
9 9 9 9 9 9 9 9 9 9 9 9 9 9 9
11 0 0 0 0 0 0 0 0 0 0 0 0 0 11
11 0 0 0 0 0 0 0 0 0 0 0 0 0 11
11 0 9 9 9 9 9 9 9 9 9 9 9 0 11
11 0 0 0 0 0 0 0 0 0 0 0 0 0 11
11 0 0 0 0 0 0 0 0 0 0 0 0 0 11
11 0 9 9 9 9 9 9 9 9 9 9 9 0 11
11 0 0 0 0 0 0 0 0 0 0 0 0 0 11
11 0 0 0 0 0 0 0 0 0 0 0 0 0 11
11 0 9 9 9 9 9 9 9 9 9 9 9 0 11
11 0 0 0 0 0 0 0 0 0 0 0 0 0 11
11 0 0 0 0 0 0 0 0 0 0 0 0 0 11
11 0 9 9 9 9 9 9 9 9 9 9 0 0 11
11 0 0 0 0 0 0 0 0 0 0 0 0 0 11
11 0 0 0 0 0 0 0 0 0 0 0 0 0 11
9 9 9 9 9 9 9 9 9 9 9 9 9 9 9